traceroute to map.fastly.net (185.31.17.78), 64 hops max, 52 byte packets
 1 192.168.1.1  1.041 ms * *
 2 192.168.88.1  1.635 ms  1.627 ms  2.673 ms
 3 10.0.255.255  4.125 ms  4.099 ms  4.086 ms
 4 * * *
 5 * * *
 6 * * *
 7 * * *
 8 * * *
 9 * * *
10 * * *
11 * * *
12 * * *
13 * * *
14 * * *
15 * * *
16 * * *
17 * * *
18 * * *
19 * * *
20 * * *
21 * * *
22 * * *
23 * * *
24 * * *
25 * * *
26 * * *
27 * * *
28 * * *
29 * * *
30 * * *
31 * * *
32 * * *
33 * * *
34 * * *
35 * * *
36 * * *
37 * * *
38 * * *
39 * * *
40 * * *
41 * * *
42 * * *
43 * * *
44 * * *
45 * * *
46 * * *
47 * * *
48 * * *
49 * * *
50 * * *
51 * * *
52 * * *
53 * * *
54 * * *
55 * * *
56 * * *
57 * * *
58 * * *
59 * * *
60 * * *
61 * * *
62 * * *
63 * * *
64 * * *
